vector<string> map = {
	".............................................................................................................................................................................................",
	".............................................................................................................................................................................................",
	".............................................................................................................................................................................................",
	".............................................................................................................................................................................................",
	".............................................................................................................................................................................................",
	".............................................................................................................................................................................................",
	".............................................................................................................................................................................................",
	".............................................................................................................................................................................................",
	".............................................................................................................................................................................................",
	".............................................................................................................................................................................................",
	".............................................................................................................................................................................................",
	".............................................................................................................................................................................................",
	".............................................................................................................................................................................................",
	".............................................................................................................................................................................................",
	".............................................................................................................................................................................................",
	".............................................................................................................................................................................................",
	".............................................................................................................................................................................................",
	".............................................................................................................................................................................................",
	".............................................................................................................................................................................................",
	".............................................................................................................................................................................................",
	".............................................................................................................................................................................................",
	".............................................................................................................................................................................................",
	".............................................................................................................................................................................................",
	".............................................................................................................................................................................................",
	".............................................................................................................................................................................................",
	".............................................................................................................................................................................................",
	".............................................................................................................................................................................................",
	".............................................................................................................................................................................................",
	".............................................................................................................................................................................................",
	".............................................................................................................................................................................................",
	".............................................................................................................................................................................................",
	".................................................................................................................############................................................................",
	".................................................................................................................#              #............................................................",
	"......................................................................................................############ ####### ######............................................................",
	"..........................................................................................#############         b   #...#   #................................................................",
	"..........................................................................................#b   KCP               ####...#   #................................................................",
	"..........................................................................................#bb       ###          #......#   #................................................................",
	".................................................................#######........#########.#######GLG#.########G G#.....##   ##...............................................................",
	".................................................................#     #...####.#    aab#.#         #.#    G     #....## P   ##..............................................................",
	".................................................................#   b #####ba###      b#.##        #.#         ##...##   A   ##.............................................................",
	".................................................................# 1     C    ## b   V  #..###      #.#    G   ##....#  c   c  ######........................................................",
	"...............................................................### 1 b #####     b#     #....########.##########.....#             ..........................................................",
	"...............................................................#       #...#  ## b b    #.......................###### z     Z ######........................................................",
	"...............................................................# #######...#  ##a  b    #########################              #.............................................................",
	"...............................................................#1#.........#  ## b#      L  L  Y             k    ####  c   c  #.............................................................",
	"...............................................................# #.#######.#~ ## b      ######bb   b###############..#    i    #.............................................................",
	"...............................................................#!#.#    C#.#   P#     bb#....########................###  K    #.............................................................",
	"...............................................................# ###L#C P#.#### b  a bs #......................#####...##      #.............................................................",
	"...............................................................#  l  #####....###########........########......#KC  #####a a####.............................................................",
	"...............................................................##### #........................####o     ##.....#  xbb         #..............................................................",
	"...................................................................#P###...........##########.#   b bb   #.....#  a ######### #..............................................................",
	"...................................................................# a #.....####..#   4  4 #.# ###5  ab #.....## ###.......# #..............................................................",
	".................................................................###b2 #.....# 3#..# 4  4 b #.# #######5 #......# #...#####.# #..............................................................",
	".................................................................# b   #.....# 3#..# b # a###.# #######5 #.....## ##### b #.# #..............................................................",
	".................................................................# 2 b2#.....#a #..# b    #...# ### # a5 #.....#   b   ba #.# #..............................................................",
	".................................................................#     #....##  #.##H###b #.### #O   5b  #.....####### b  #.# #..............................................................",
	".................................................................### ###....# b #.#  #.#  #.#   # ########...........###a #.#X#..............................................................",
	"...................................................................#2#......#   #.# ##.## ### ###5#....................#  ### #..............................................................",
	"...................................................................# #.######abb#.# #...#4   &#.# ########.............# b   e#..............................................................",
	"...................................................................#?#.#  j    3#.#h#...#######.#     %  ##............##bav ##..............................................................",
	".................................................................### ### ##### ##.# #...........########  #.............#   a#...............................................................",
	".................................................................#  ba   #...# #..# #..................## ##............######...............................................................",
	"..............................................................#### a a ab#...# #### #..#######..........#  #.................................................................................",
	"..............................................................#         b#...#3    ^#..#     ####...#####ar############......................................................................",
	"..............................................................# ##########...########..#  p     #...#  L       R  C  t#......................................................................",
	"..............................................................#J###....................#        #...# ############### #......................................................................",
	"..............................................................#   #....................##########...# #.............# #......................................................................",
	"..............................................................### ####..............................# #.............# #......................................................................",
	"...............................................................##    #...###########.......########## #.............# #......................................................................",
	"...............................................................#q b  #...#         #.......#          #.............# #......................................................................",
	"...............................................................### bq#...# ####### #.......# ##########..#######....# #......................................................................",
	"...............................................................#q##b #...# #.....# ######### #...........#aCCaa#....#T#......................................................................",
	"...............................................................# # q ###.# #...###      g    #.......##### b  a#....# #......................................................................",
	"...............................................................#b Qbbq #.# #..##b       g K  #.......#CaCC   CC#....#C#......................................................................",
	"...............................................................#   q   #.# #..#a   P   #########.....#C     ####....# #......................................................................",
	"...............................................................## ######.# #..#              aa#.....#CCC   #.......#C#......................................................................",
	"................................................................# #......# #..#               a#.....#C   CC#.......# #......................................................................",
	"................................................................# ######## #..#b               #.....#   CCb####...## ##.....................................................................",
	"................................................................#  q    *  #..#   b#GGGG####ggg#.....# C  Cbba##...# E #.....................................................................",
	"................................................................############..#  bb#    #..#   #.....#CC   CCC#....#   #.....................................................................",
	"..............................................................................######  p #..#s C#.....#bCaa CCC#....#cwc#.....................................................................",
	"...................................................................................######..#####.....##########....#####.....................................................................",
	".............................................................................................................................................................................................",
	".............................................................................................................................................................................................",
	".............................................................................................................................................................................................",
	".............................................................................................................................................................................................",
	".............................................................................................................................................................................................",
	".............................................................................................................................................................................................",
	".............................................................................................................................................................................................",
	".............................................................................................................................................................................................",
	".............................................................................................................................................................................................",
	".............................................................................................................................................................................................",
	".............................................................................................................................................................................................",
	".............................................................................................................................................................................................",
	".............................................................................................................................................................................................",
	".............................................................................................................................................................................................",
	".............................................................................................................................................................................................",
	".............................................................................................................................................................................................",
	".............................................................................................................................................................................................",
	".............................................................................................................................................................................................",
	".............................................................................................................................................................................................",
	".............................................................................................................................................................................................",
	".............................................................................................................................................................................................",
	".............................................................................................................................................................................................",
	".............................................................................................................................................................................................",
	".............................................................................................................................................................................................",
	".............................................................................................................................................................................................",
	".............................................................................................................................................................................................",
};
